NO ./path_to_the_north_texture
SO ./path_to_the_south_texture
WE ./path_to_the_west_texture
EA 			./path_to_the_east_texture


C 225,30,255

F 220,100,0


       1111111111111111111111111
       1000000000110000000000001
       1011000001110000000000001
       10010000000000000000000011
11111111101100000111000000000000111111111
100000000011000001110111111111111
11110111111111011100000010001
11110111111111011111010010011
110000001101010111W100010001
10000000000000001111000010011
10000000000000001101010010001
1100000111010101111101111000111
11110111 1110101 10111101000101
1111111111111111111111111111111