NO ./S.png
SO ./S.png
WE ./S.png
EA 	./S.png


C 115,172,238

F 81,172,102


    111111111111111111111111111111111
    100000000000000000100000000000001111
    101100000100000000100000000000000001
    100010000000000000000000000000001111
1111111110110000000000001110000000000001
1000000000110000000000001110111111111111
111101111111110000000011100000010001111111111
1111011111111100000000111010000000000010010001
1100000011010100000000111000000000000000010001
1000000000000000000000011000000000000000010001
1000000000000000000000011000000000000000010001
1000000000000000000000011000000000000000010001
1000000000000000000000011000000000000000010001
1000000000000000000000011000000000000000010001
1000000000000000000000011000000000000000010001
1000000000000000000000011000000000000000010001
1000000000000000000000011000000000000000010001
1000000000000000000000011000000000000000010001
1000000000000000000000011010000000000010000001
110000011101010N111101111000111111111111111111
11110111 11101011  101111010001
11111111 1111111  111111111111
11111111 1111111 111111111111
11111111111
