NO ./path_to_the_north_texture
SO ./path_to_the_south_texture
WE ./path_to_the_west_texture
EA 			./path_to_the_east_texture


C 115,172,238

F 81,172,102


111111111111111
101000000000101
101000000000101
101000000000101
1010000N0000101
101001000100101
100001000100001
100001000100001
111111111111111