NO ./assets/walls/N.png
SO ./assets/walls/S.png
WE ./assets/walls/W.png
EA 	./assets/walls/E.png


C 115,172,238

F 81,172,102



111111111111111111111111111111111111
1E0000100011100011100010001110111111
1010M01000D000000010M010001M000000101
1010101000100011101110111010001110101
1110101110100010000000000010001000101
1000111000100010M011111101110001010101
100010111011101110100000D010000010101
100010000010000000101110101011111101
10001011101000111010101010100000001
100M10M0101000100010101010111011101
11D11000101110100010101010M0001M001
10000000100000100010100010000D00001
10111111101111111111111111011101111
10001000100010000000100010001000001
11101011101110111011101110111010101
100010000010D0001000100010001010101
10111011101M11101110111010111010001 
100000100000100010000010100M1011101
11111111111111111111111111111111101
                                101
                                101
                                101
                                101
                                101
                                1T1
                                111