NO ./assets/walls/N.png
SO ./assets/walls/S.png
WE ./assets/walls/W.png
EA 	./assets/walls/E.png


C 115,172,238

F 81,172,102


    111111111111111111111111111111111
    100000000000000000100000000000001111
    101100000100000000100000000000000001
    100010000000000000000000000000001111
1111111110110000000000001110000000000001
1000000000110000000000001110111111111111
111101111111110000000011100000010001111111111
1111011111111100000000111010000000000010010001
11000000110101000000001110000000000000000010001
100000000000000000000001100000000000000000010001
10000000000111D111000001100DDDDDDDDDD00000010001
100000000000D0000000000110000000000000000010001
1000D000000000000000000110000000000000000010001
10000DD000000000000000011000000DDDDD00000010001
10000000000000000000000110000000000000000010001
10000MM0000000MMM000000110000000000000000010001
100000000000000DMMT0000110000000000000000010001
1MMMMMMMMMM000000000000110000000000000000010001
100000M0000000000000000110100000000000100000001
110000011101010N111101111000111111111111111111
11110111 11101011  101111010001
11111111 1111111  111111111111
11111111 1111111 111111111111
11111111111
